................#...#..#...#...#...#..#......................................................;...
.............................................................................................;...
.............................................................................................;...
..................V..................V.......................................................;...
.........................V...................................................................;..H
.............................V..........V..........................c.........c..c........H...;...
...........................................cccc...................c.1222222223...c...........;...
......................V..........V........12222223...#....P.......#.4555555556....c....C.....;...
22222222222226............................45555556....122222222223..4555555556....122222222223...
55555555555556..#...#..#...#...#...#..#...45555556....455555555556..4555555556....455555555556...