......................................................................................;.........
......................................................................................;.........
....................................................................................H.;..#......
..................................................H...................................;.........
................c.............................................................H.......;..#......
...............c#.....G......#........................................c...............;.........
..............c..123/----\123........................#........G....#...c.........C....;.........
.................456......456...923..ccccc..9/---\8...1222222222223....9123/----\122223.........
12222222222223oso476ososos456osos4522222223osososososo4555557555556ososo456ososos455556.........
45555755555556www456wwwwww456wwww4555555556wwwwwwwwwww4555555555556wwwww456wwwwww455556.........