........................................................................................;.........
........................................................................................;.........
........................................................................................;.........
...............c........................................................................;.........
..............c.c..................c....................................................;.........
.............c...c................c.c.................cccc...................c..........;.........
.............3.............ccc...c...c..............1222222223...#...P.....#..c.........;.........
............16...#..P....#12222223...#....P.......#.4555555556....122222223....c...C....;.........
22222222222226....1222222255555556....122222222223..4555555556....455555556....122222222223.......
55555555555556....4555555555555556....455555555556..4555555556....455555556....455555555556.......